NO textures/checker_north.xpm
SO textures/checker_south.xpm
WE textures/checker_west.xpm
EA textures/checker_east.xpm

F 34,139,34
C 135,206,235

11111
10001
10001
100N1
10011
11111