NO textures/checker_north.xpm
SO textures/checker_south.xpm
WE textures/checker_west.xpm
EA textures/checker_east.xpm

F 34,139,34
C 135,206,235

11111
100011
100011
10E001
100011
10001
10001
10001
10001
11111