NO textures/checker_north.xpm
SO textures/checker_south.xpm
WE textures/checker_west.xpm
EA textures/checker_east.xpm

F 34,139,34
C 135,206,235

111111111
111101111
111101111
111000111
1000N0001
111000111
111101111
111101111
111111111