NO textures/clem_north.xpm
SO textures/south_texture
WE textures/west_texture
EA textures/east_texture

F 34,139,34
C 135,206,235

        1111111111111111111111111
        1000000000010000000000001
        1000000000110000000000001
        1001000000000000000000001
111111111011000001110100000000001
100000000010000001000111111111111
11110111111001011100000010001
10000000001111000100000010001
10000000000100000100000010001
10000000000000000000000010001
10000000000000011100000010001
1000000111000001 100000000N01
10000001 1100001 100000010001
11111111  111111 111111111111