NO textures/north_texture
SO textures/south_texture
WE textures/west_texture
EA textures/east_texture

F 220,100,0
C 225,30,0

1111111
1000101
1000101
10001N1
1000001
1111111