NO textures/space_plain.xpm
SO textures/space_plain.xpm
WE textures/space_window.xpm
EA textures/space_aeration.xpm

F 45,45,45
C 25,25,25

111111
1000011
10S0001
1000001
1000011  1111
110111  110011
 101   11000011
 101111100000011
 100000000000001
 110111100000001
  101  100000011
  111  11000011
       1110111
         101
         101
         101
        11011
       1100011
      110000011
      100000001
      100000001
      100000001
      110000011
       1100011
        11111